ppppppppppppppppppppppppppppppppppppppppppppppppppppppppppppppppppppppppppppppppppppppppppppppppppp
p.............................................................................sss.................p
p.............................................................................sss.................p
p........########....#########.....###############............................sss.................p
p........#cccccc#....#ccccccc#.....#ccccccccccccc#............................sss.................p
p........#cccccc#....#ccccccc#.....#ccccccccccccc#............................sss.................p
p........#cccccc#....#ccccccc#.....#ccccccccccccc#............................sss.................p
p........#cccccc#....#ccccccc#.....#ccccccccccccc#............................sss.................p
p........#cccccc#....#ccccccc#.....#ccccccccccccc#............................sss.................p
p........###cc###....####c####.....###cc##########............................sss.................p
p.............................................................................sss.................p
p.............................................................................sss.................p
peeeeeeeeeeeeeeeeeeeeeeeeeeeeeeeeeeeeeeeeeeeeeeeeeeeeeeeeeeeeeeeeeeeeeeeeeeeeesss.................p
peeeeeeeeeeeeeeeeeeeeeeeeeeeeeeeeeeeeeeeeeeeeeeeeeeeeeeeeeeeeeeeeeeeeeeeeeeeeesss.................p
p.............................................................................sss.................p
p.............................................................................sss.................p
p.............................................................................sss.................p
p.............................................................................sss.................p
p.............................................................................sss.................p
p.............................................................................sss.................p
p.............................................................................sss.................p
p.............................................................................sss.................p
p.............................................................................sss.................p
p.............................................................................sss.................p
p.............................................................................sss.................p
p.............................................................................sss.................p
p.............................................................................sss.................p
p.............................................................................sss.................p
p.............................................................................sss.................p
p.............................................................................spp.................p
p.............................................................................spp.................p
p.............................................................................spp.................p
p.............................................................................spp.................p
p.............................................................................sss.................p
p.............................................................................sss.................p
p.............................................................................sss.................p
ppppppppppppppppppppppppppppppppppppppppppppppppppppppppppppppppppppppppppppppppppppppppppppppppppp